NO ./textures/north.png
SO ./textures/south.png
WE ./textures/west.png
EA ./textures/east.png

C 1,205,254
F 5,255,161

1111111
1S00001
1000101
1000001
1111111
