NO ./textures/north.png
SO ./textures/south.png
WE ./textures/west.png
EA ./textures/east.png

F 1,205,254
C 5,255,161
                   
                   
                   
                   
                   
                   
      1111111      
      1000001      
      10N000       
      1000001      
      1111111      
                   
                   
                   
                   
                   
                   
                   
                   
