NO ./textures/north.png
SO ./textures/south.png
WE ./textures/west.png
EA ./textures/east.png

F 1,205,254
C 5,255,161

                   
                   
                   
                   
                   
                   
      1111111      
      1000001      1111111
      1000001111111111111111111111      
      10000N1      
      1111111      
                   
                   
                   
                   
                   
                   
                   
                   
